You are lost in the forest looking for a specific type of herb. The herb you are looking for is called Holy Basil. It's purple and tall. You need the herb to heal your sick mother. You don't know your way back home and assume you have strayed very far from your home. You can't retrace your steps. You're pretty sure that you've been walking in circles for the past hour and a half. The goal is to find your way home, find the Holy Basil, and overcome difficult tasks that come your way.

Lost in the Forest
An Interactive Fiction by Natalie Wong
Release 1 / Serial number 160214 / Inform 7 build 6L38 (I6/v6.33 lib 6/12N) SD

Forest
The forest has many different trees. They are all about 20 meters high and the lowest branch is 3 feet above you. You see a key and a stone lying on the ground. You are lost in the forest and want to find a way home and the Holy Basil to heal your sick mother. There is a clearing in the North. There are more trees n

Southeast. I think I saw a Lady who can help you in the North.

The key hangs from a branch. You can't reach it. It unlocks a treasure chest.

>north
Clearing
In the clearing stands a Lady who looks at you. She doesn't acknowledge you in any way, just stares. You are a big freaked out but you don't say anything. Maybe you should ask her about the key. It doesn't hurt to make new friends once in a while!

* * *

>take key
You can't take the key because it's to high.

>move stone
You push the stone and now you can step on top to get the key!

>step on key
That's not a verb I recognise.

>step on stone
That's not a verb I recognise.

>go on stone
You can't see any such thing.

>move to stone
You can't see any such thing.

>step on top of stone
That's not a verb I recognise.

>take key
You can't take the key because it's to high.

>get on stone
You get onto stone.

>take key
Now that you're on top of the stone, the key is at arms length! Stretching out your hand, you just barely snatch the key from the tree.

>get off stone
You get off stone.

Forest
The forest has many different trees. They are all about 20 meters high and the lowest branch is 3 feet above you. You see a key and a stone lying on the ground. You are lost in the forest and want to find a way home and the Holy Basil to heal your sick mother. There is a clearing in the North. There are more trees n

Southeast. I think I saw a Lady who can help you in the North.

>go se
Trees
There are even more trees and a path that leads Southwest. There is a treasure chest here. Do you perhaps have the key to open it?

>open treasure chest
It seems to be locked.

>unlock treasure chest
(with Key)
You unlock treasure chest.

>open chest
Inside the treasure chest is a pearl necklace! This must be the same pearl necklace the Lady was talking about! The pearls look real and the necklace is very pretty. You should give the necklace to the Lady... or you can keep it, whatever you choose.

>take pearl necklace
You should give this necklace to the Lady.

>i
You are carrying:
  a pearl necklace
  Key

>ne
You can't go that way! We have to keep going on the quest and it looks like there's dangerous poison ivy over there! Let's go a different way, it seems like a safer path.

>nw
Forest
The forest has many different trees. They are all about 20 meters high and the lowest branch is 3 feet above you. You see a key and a stone lying on the ground. You are lost in the forest and want to find a way home and the Holy Basil to heal your sick mother. There is a clearing in the North. There are more trees n

Southeast. I think I saw a Lady who can help you in the North.

>n
Clearing
In the clearing stands a Lady who looks at you. She doesn't acknowledge you in any way, just stares. You are a bit freaked out but you don't say anything. It doesn't hurt to make new friends once in a while! You should ask her about the purple plant.

>ask lady about purple plant
The purple plant I believe is at the Water Hole if I remember last!

>se
You can't go that way! We have to keep going on the quest and it looks like there's dangerous poison ivy over there! Let's go a different way, it seems like a safer path.

>sw
You can't go that way! We have to keep going on the quest and it looks like there's dangerous poison ivy over there! Let's go a different way, it seems like a safer path.

>s
Forest
The forest has many different trees. They are all about 20 meters high and the lowest branch is 3 feet above you. You see a key and a stone lying on the ground. You are lost in the forest and want to find a way home and the Holy Basil to heal your sick mother. There is a clearing in the North. There are more trees n

Southeast. I think I saw a Lady who can help you in the North.

>se
Trees
There are even more trees and a path that leads Southwest. There is a treasure chest here. Do you perhaps have the key to open it?

>sw
Water Hole
You see a purplish plant that looks like an herb. Maybe you should look at it... unless it's poisonous.

>take the purple plant
You should go back to the Lady and show her your plant. Maybe she'll tell you scientific facts about it! Now you have the plant to heal your sick mother!

>ne
Trees
There are even more trees and a path that leads Southwest. There is a treasure chest here. Do you perhaps have the key to open it?

>nw
Forest
The forest has many different trees. They are all about 20 meters high and the lowest branch is 3 feet above you. You see a key and a stone lying on the ground. You are lost in the forest and want to find a way home and the Holy Basil to heal your sick mother. There is a clearing in the North. There are more trees n

Southeast. I think I saw a Lady who can help you in the North.

* * *

>n
Clearing
In the clearing stands a Lady who looks at you. She doesn't acknowledge you in any way, just stares. You are a bit freaked out but you don't say anything. It doesn't hurt to make new friends once in a while! You should ask her about the purple plant.

>give the lady the purple plant
Lady doesn't seem interested.

>give lady peal necklace
You can't see any such thing.

>give lady pearl necklace
Thank you so much for finding my beautiful pearl necklace!  If you travel Northwest, you shall find the path that leads to home.

>nw
Home
"Wait!" says the Lady. Her arm is out trying to stop you. With the other arm, the Lady takes out a perfume bottle, sprays once, and a magical portal appears. 

 "Go on," says that Lady. "When you walk through the portal, you will arrive safe at home." 
 
You decide to trust the Lady, after all she told you how to get the key. You walk forward and the Lady gives an encouraging nod. She smiles slightly and you walk into the portal. 
 
You feel a cool breeze around your body and suddenly you're back at home. 
 
"Are you home?" calls your mother. Better go heal her with the Holy Basil you collected in the forest!

You see a mirror. You should take the mirror. Welcome Home!

* * *

>move stone
You push the stone and now you can step on top to get the key!

>get on stone
You get onto stone.

* * *

>take key
Now that you're on top of the stone, the key is at arms length! Stretching out your hand, you just barely snatch the key from the tree.

>get off stone
You get off stone.

Forest
The forest has many different trees. They are all about 20 meters high and the lowest branch is 3 feet above you. You see a key and a stone lying on the ground. You are lost in the forest and want to find a way home and the Holy Basil to heal your sick mother. There is a clearing in the North. There are more trees in the Southeast. I think I saw a Lady who can help you in the North.

>n
Clearing
In the clearing stands a Lady who looks at you. She doesn't acknowledge you in any way, just stares. You are a big freaked out but you don't say anything. Maybe you should ask her about the key. It doesn't hurt to make new friends once in a while!

>ask lady about key
Move the stone to get the key. I lost a pearl necklace somewhere in the forest. If you can find my pearl necklace, I will help you show you the way home.

>s
Forest
The forest has many different trees. They are all about 20 meters high and the lowest branch is 3 feet above you. You see a key and a stone lying on the ground. You are lost in the forest and want to find a way home and the Holy Basil to heal your sick mother. There is a clearing in the North. There is more trees in the Southeast.

>se
Trees
There are even more trees and a path that leads Southwest. There is a treasure chest here.

>open chest with key
You unlock treasure chest.

>open chest
Inside the treasure chest is a pearl necklace! This must be the same pearl necklace the Lady was talking about! We should give it to her.

>take neck
You can't see any such thing.

>take necklace
Taken.

>nw
Forest
The forest has many different trees. They are all about 20 meters high and the lowest branch is 3 feet above you. You see a key and a stone lying on the ground. You are lost in the forest and want to find a way home and the Holy Basil to heal your sick mother. There is a clearing in the North. There is more trees in the Southeast.

>n
Clearing
In the clearing stands a Lady who looks at you. She doesn't acknowledge you in any way, just stares. You are a big freaked out but you don't say anything. Maybe you should ask her about the key. It doesn't hurt to make new friends once in a while!

>give necklace to lady
Thank you so much for finding my beautiful pearl necklace! Have you gotten the purple herb?

>ne
No need to explore that way now. It's not part of this adventure.

>nw
Home
The Lady takes out a perfume bottle, sprays once, and a magical portal appears. 

 "Go on," says that Lady. "When you walk through the portal, you will arrive safe at home." 
 
You decide to trust the Lady, after all she told you how to get the key. You walk forward and the Lady gives an encouraging nod. She smiles slightly and you walk into the portal. 
 
You feel a cool breeze around your body and suddenly you're back at home. 
 
"Are you home?" calls your mother. Better go tend to her needs!

>se
Clearing
In the clearing stands a Lady who looks at you. She doesn't acknowledge you in any way, just stares. You are a big freaked out but you don't say anything. Maybe you should ask her about the key. It doesn't hurt to make new friends once in a while!

>n
No need to explore that way now. It's not part of this adventure.

I beg your pardon?

>s
Forest
The forest has many different trees. They are all about 20 meters high and the lowest branch is 3 feet above you. You see a key and a stone lying on the ground. You are lost in the forest and want to find a way home and the Holy Basil to heal your sick mother. There is a clearing in the North. There is more trees in the Southeast.

* * *

>se
Trees
There are even more trees and a path that leads Southwest. There is a treasure chest here.

>sw
Water Hole
You see a purplish plant that looks like a herb. Maybe you should look at it... unless it's poisonous.

A ladder is leaning against a tree. Might this have some use for you? Besides, you don't see a ladder everyday in the middle of the forest.

>take plant
You can't see any such thing.

>take Holy Basil
Taken.

* * *

>get off stone
You get off stone.

Forest
The forest has many different trees. They are all about 20 meters high and the lowest branch is 3 feet above you. You see a key and a stone lying on the ground. You are lost in the forest and want to find a way home and the Holy Basil to heal your sick mother. There is a clearing in the North. There are more trees in the Southeast. I think I saw a Lady who can help you in the North.

>drop key
Dropped.

>take key
You take the key off the ground.

>i
You are carrying:
  Key

* * *

>move stone
You push the stone and now you can step on top to get the key!

>get on stone
You get onto Stone.

>take key
Now that you're on top of the stone, the key is at arms length! Stretching out your hand, you just barely snatch the key from the tree.

>get off stone
You get off Stone.

Forest
The forest has many different trees. They are all about 20 meters high and the lowest branch is 3 feet above you. You see a key and a stone lying on the ground. You are lost in the forest and want to find a way home and the Holy Basil to heal your sick mother. There is a clearing in the North. There is more trees in the Southeast. I think I saw a Lady who can help you in the North.

>se
Trees
There are even more trees and a path that leads Southwest. There is a treasure chest here. Do you perhaps have the key to open it?

>unlock chest with key
You unlock treasure chest.

>open chest
Inside the treasure chest is a pearl necklace! This must be the same pearl necklace the Lady was talking about! The pearls look real and the necklace is very pretty. You should give the necklace to the Lady... or you can keep it, whatever you choose.

* * *

>take pearl necklace
You should give this necklace to the Lady.

>nw
Forest
The forest has many different trees. They are all about 20 meters high and the lowest branch is 3 feet above you. You see a key and a stone lying on the ground. You are lost in the forest and want to find a way home and the Holy Basil to heal your sick mother. There is a clearing in the North. There is more trees in the Southeast. I think I saw a Lady who can help you in the North.

>n
Clearing
In the clearing stands a Lady who looks at you. She doesn't acknowledge you in any way, just stares. You are a bit freaked out but you don't say anything. Maybe you should ask her about the key. You should ask her about the purple plant as well. It doesn't hurt to make new friends once in a while!

>give necklace to lady
Thank you so much for finding my beautiful pearl necklace! Have you gotten the purple herb?

>ask lady about purple plant
The purple plant I believe is at the Water Hole if I remember last!

>s
Forest
The forest has many different trees. They are all about 20 meters high and the lowest branch is 3 feet above you. You see a key and a stone lying on the ground. You are lost in the forest and want to find a way home and the Holy Basil to heal your sick mother. There is a clearing in the North. There is more trees in the Southeast. I think I saw a Lady who can help you in the North.

>se
Trees
There are even more trees and a path that leads Southwest. There is a treasure chest here. Do you perhaps have the key to open it?

>sw
Water Hole
You see a purplish plant that looks like a herb. Maybe you should look at it... unless it's poisonous.

* * *

>take stone
You don't have enough back strength to carry the stone everywhere. Shame on you for trying to hurt your back.

>i
You are carrying nothing.

* * *

>take key
You can't take the key because it's to high.

>n
Clearing
In the clearing stands a Lady who looks at you. She doesn't acknowledge you in any way, just stares. You are a bit freaked out but you don't say anything. Maybe you should ask her about the key. You should ask her about the purple plant as well. It doesn't hurt to make new friends once in a while!

>ask lady about key
She stares at you and says nonchalantly, "Push the stone to get the key... Also I recently lost a pearl necklace somewhere in the forest. If you can find my pearl necklace, I will help you show you the way home. I have also seen that purple plant you've been looking for... Holy Basil it's called? I don't remember but I think was either south or southeast from here. I'm quite an old Lady, I don't remember much. But if you could find my pearl necklace, I would be a happy old Lady!"

>s
Forest
The forest has many different trees. They are all about 20 meters high and the lowest branch is 3 feet above you. You see a key and a stone lying on the ground. You are lost in the forest and want to find a way home and the Holy Basil to heal your sick mother. There is a clearing in the North. There is more trees in the Southeast. I think I saw a Lady who can help you in the North.

The key hangs from a branch. You can't reach it. It unlocks a treasure chest.

>push stone
You push the stone and now you can reach the key!

>take key
You can't take the key because it's to high.

>get on the stone
You get onto Stone.

>take key
Now that you're on top of the stone, the key is at arms length! Stretching out your hand, you just barely snatch the key from the tree.

>n
(first getting off Stone)

Clearing
In the clearing stands a Lady who looks at you. She doesn't acknowledge you in any way, just stares. You are a bit freaked out but you don't say anything. Maybe you should ask her about the key. You should ask her about the purple plant as well. It doesn't hurt to make new friends once in a while!

>give lady key
Lady doesn't seem interested.

>s
Forest
The forest has many different trees. They are all about 20 meters high and the lowest branch is 3 feet above you. You see a key and a stone lying on the ground. You are lost in the forest and want to find a way home and the Holy Basil to heal your sick mother. There is a clearing in the North. There is more trees in the Southeast. I think I saw a Lady who can help you in the North.

* * *

>se
Trees
There are even more trees and a path that leads Southwest. There is a treasure chest here. Do you perhaps have the key to open it?

>unlock chest woth key
I didn't understand that sentence.

>unlock chest with key
You unlock treasure chest.

* * *

>open chest
Inside the treasure chest is a pearl necklace! This must be the same pearl necklace the Lady was talking about! The pearls look real and the necklace is very pretty. You should give the necklace to the Lady... or you can keep it, whatever you choose.

>put on necklace
(first taking the pearl necklace)
You should give this necklace to the Lady.

You can't wear that!

>nw
Forest
The forest has many different trees. They are all about 20 meters high and the lowest branch is 3 feet above you. You see a key and a stone lying on the ground. You are lost in the forest and want to find a way home and the Holy Basil to heal your sick mother. There is a clearing in the North. There is more trees in the Southeast. I think I saw a Lady who can help you in the North.

>i
You are carrying:
  a pearl necklace
  Key

>n
Clearing
In the clearing stands a Lady who looks at you. She doesn't acknowledge you in any way, just stares. You are a bit freaked out but you don't say anything. Maybe you should ask her about the key. You should ask her about the purple plant as well. It doesn't hurt to make new friends once in a while!

>give lady pearl neckalce
I only understood you as far as wanting to give Lady the pearl necklace.

>give lady pearl necklace
Thank you so much for finding my beautiful pearl necklace! Have you gotten the purple herb?

>ask lady about purple herb
There is no reply.

>ask lady about holy basil
There is no reply.

>ask lady about purple plant
The purple plant I believe is at the Water Hole if I remember last!

>ask lady about water hole
There is no reply.

>s
Forest
The forest has many different trees. They are all about 20 meters high and the lowest branch is 3 feet above you. You see a key and a stone lying on the ground. You are lost in the forest and want to find a way home and the Holy Basil to heal your sick mother. There is a clearing in the North. There is more trees in the Southeast. I think I saw a Lady who can help you in the North.

* * *

>sw
Water Hole
You see a purplish plant that looks like a herb. Maybe you should look at it... unless it's poisonous.

>take purple plant
You should go back to the Lady and ask her about this plant. Maybe she'll tell you scientific facts about it! Now you have the plant to heal your sick mother!

>ne
Trees
There are even more trees and a path that leads Southwest. There is a treasure chest here. Do you perhaps have the key to open it?

>nw
Forest
The forest has many different trees. They are all about 20 meters high and the lowest branch is 3 feet above you. You see a key and a stone lying on the ground. You are lost in the forest and want to find a way home and the Holy Basil to heal your sick mother. There is a clearing in the North. There is more trees in the Southeast. I think I saw a Lady who can help you in the North.

* * *

>n
Clearing
In the clearing stands a Lady who looks at you. She doesn't acknowledge you in any way, just stares. You are a bit freaked out but you don't say anything. Maybe you should ask her about the key. You should ask her about the purple plant as well. It doesn't hurt to make new friends once in a while!

>give lady purple plant
Lady doesn't seem interested.

>ask lady about purple plant
If you travel Northwest, you shall find the path that will lead you home!

>i
You are carrying:
  Purple plant
  Key

>show lady purple plant
Lady is unimpressed.

>\
That's not a verb I recognise.

>nw
Home
"Wait!" says the Lady. Her arm is out trying to stop you. With the other arm, the Lady takes out a perfume bottle, sprays once, and a magical portal appears. 

 "Go on," says that Lady. "When you walk through the portal, you will arrive safe at home." 
 
You decide to trust the Lady, after all she told you how to get the key. You walk forward and the Lady gives an encouraging nod. She smiles slightly and you walk into the portal. 
 
You feel a cool breeze around your body and suddenly you're back at home. 
 
"Are you home?" calls your mother. Better go see what she needs!

You see a mirror. You should take the mirror. Welcome Home!

>take mirror
You have reached home! You are as perfect as when you left the cottage and now you even have the Holy Basil! You're glowing and have a bright smile on your face. Have a wonderful day!

    *** After you took the mirror, you looked very much the same. You saved your mother using the Holy Basil. You never did see the Lady again, but you always thought of her. Like "How did she even use a PERFUME bottle to open a portal?" you never found the answer, but you knew you were always in her debt. Although she stared at you quite creepily. ***

Would you like to RESTART, RESTORE a saved game, QUIT or UNDO the last command?

>ERSTART
Please give one of the answers above.

Would you like to RESTART, RESTORE a saved game, QUIT or UNDO the last command?

>RETAT
Please give one of the answers above.

Would you like to RESTART, RESTORE a saved game, QUIT or UNDO the last command?

>RESTART
You have gotten lost in the forest looking for a specific type of herb. The herb you are looking for is called Holy Basil. It's purple and tall. You need the herb to heal your sick mother. Right now, you're lost in the forest and you don't know how to go back home. You have strayed very far from your home and can't retrace your steps. You're pretty sure that you've been walking in circles for the past hour and a half. The goal is to find a way home, find the Holy Basil, and overcome difficult tasks.

Lost in the Forest
An Interactive Fiction by Natalie Wong
Release 1 / Serial number 150902 / Inform 7 build 6L38 (I6/v6.33 lib 6/12N) SD

Forest
The forest has many different trees. They are all about 20 meters high and the lowest branch is 3 feet above you. You see a key and a stone lying on the ground. You are lost in the forest and want to find a way home and the Holy Basil to heal your sick mother. There is a clearing in the North. There is more trees in the Southeast. I think I saw a Lady who can help you in the North.

The key hangs from a branch. You can't reach it. It unlocks a treasure chest.

>take key
You can't take the key because it's to high.

>take stone
Taken.

>drop stone
Dropped.

>take stone
Taken.

>n
Clearing
In the clearing stands a Lady who looks at you. She doesn't acknowledge you in any way, just stares. You are a bit freaked out but you don't say anything. Maybe you should ask her about the key. You should ask her about the purple plant as well. It doesn't hurt to make new friends once in a while!

>nw
You can't go that way yet! You haven't completed your tasks!

>take mirror
You can't see any such thing.

* * *

>n
Clearing
In the clearing stands a Lady who looks at you. She doesn't acknowledge you in any way, just stares. You are a bit freaked out but you don't say anything. Maybe you should ask her about the key. You should ask her about the purple plant as well. It doesn't hurt to make new friends once in a while!

>give lady stone
Lady doesn't seem interested.

>ask lady about stone
There is no reply.

>kick lady
That's not a verb I recognise.

>x me
I don't know what I look like in the middle of the forest.

>ask lady about Holy Basil
There is no reply.

>ask lady about plant
The purple plant I believe is at the Water Hole if I remember last!

>ask lady about key
She stares at you and says nonchalantly, "Push the stone to get the key... Also I recently lost a pearl necklace somewhere in the forest. If you can find my pearl necklace, I will help you show you the way home. I have also seen that purple plant you've been looking for... Holy Basil it's called? I don't remember but I think was either south or southeast from here. I'm quite an old Lady, I don't remember much. But if you could find my pearl necklace, I would be a happy old Lady!"

>nw
You can't go that way yet! You haven't completed your tasks!

>s
Forest
The forest has many different trees. They are all about 20 meters high and the lowest branch is 3 feet above you. You see a key and a stone lying on the ground. You are lost in the forest and want to find a way home and the Holy Basil to heal your sick mother. There is a clearing in the North. There is more trees in the Southeast. I think I saw a Lady who can help you in the North.

The key hangs from a branch. You can't reach it. It unlocks a treasure chest.

>move stone
You push the stone and now you can reach the key!

>take key
You can't take the key because it's to high.

>get on stone
You can only get into something free-standing.

>drop stone
Dropped.

>push stone
You push the stone and now you can reach the key!

* * *

>take key
You can't take the key because it's to high.

>get on stone
You get onto Stone.

* * *

>take key
Now that you're on top of the stone, the key is at arms length! Stretching out your hand, you just barely snatch the key from the tree.

>se
(first getting off Stone)

Trees
There are even more trees and a path that leads Southwest. There is a treasure chest here. Do you perhaps have the key to open it?

>open treasure chest
It seems to be locked.

* * *

>unlock treasure chest
(with Key)
You unlock treasure chest.

>open treasure chest
Inside the treasure chest is a pearl necklace! This must be the same pearl necklace the Lady was talking about! The pearls look real and the necklace is very pretty. You should give the necklace to the Lady... or you can keep it, whatever you choose.

>take pearl necklace
You should give this necklace to the Lady.

>put on necklace
You can't wear that!

>drop necklace
Dropped.

>take necklace
You should give this necklace to the Lady.

>nw
Forest
The forest has many different trees. They are all about 20 meters high and the lowest branch is 3 feet above you. You see a key and a stone lying on the ground. You are lost in the forest and want to find a way home and the Holy Basil to heal your sick mother. There is a clearing in the North. There is more trees in the Southeast. I think I saw a Lady who can help you in the North.

You can see Stone here.

>n
Clearing
In the clearing stands a Lady who looks at you. She doesn't acknowledge you in any way, just stares. You are a bit freaked out but you don't say anything. Maybe you should ask her about the key. You should ask her about the purple plant as well. It doesn't hurt to make new friends once in a while!

* * *

>ask lady about purple plant
The purple plant I believe is at the Water Hole if I remember last!

>nw
You can't go that way yet! You haven't completed your tasks!

>s
Forest
The forest has many different trees. They are all about 20 meters high and the lowest branch is 3 feet above you. You see a key and a stone lying on the ground. You are lost in the forest and want to find a way home and the Holy Basil to heal your sick mother. There is a clearing in the North. There is more trees in the Southeast. I think I saw a Lady who can help you in the North.

You can see Stone here.

>sw
You can't go that way! We have to keep going on the quest and it looks like there's dangerous poison ivy over there! Let's go a different way, it seems like a safer path.

>se
Trees
There are even more trees and a path that leads Southwest. There is a treasure chest here. Do you perhaps have the key to open it?

>s
You can't go that way! We have to keep going on the quest and it looks like there's dangerous poison ivy over there! Let's go a different way, it seems like a safer path.

>sw
Water Hole
You see a purplish plant that looks like a herb. Maybe you should look at it... unless it's poisonous.

>take pruple plant
You can't see any such thing.

>take purple plant
You should go back to the Lady and ask her about this plant. Maybe she'll tell you scientific facts about it! Now you have the plant to heal your sick mother!

* * *

>ne
Trees
There are even more trees and a path that leads Southwest. There is a treasure chest here. Do you perhaps have the key to open it?

>nw
Forest
The forest has many different trees. They are all about 20 meters high and the lowest branch is 3 feet above you. You see a key and a stone lying on the ground. You are lost in the forest and want to find a way home and the Holy Basil to heal your sick mother. There is a clearing in the North. There is more trees in the Southeast. I think I saw a Lady who can help you in the North.

You can see Stone here.

* * *

>n
Clearing
In the clearing stands a Lady who looks at you. She doesn't acknowledge you in any way, just stares. You are a bit freaked out but you don't say anything. Maybe you should ask her about the key. You should ask her about the purple plant as well. It doesn't hurt to make new friends once in a while!

>ask lady for scientific facts
You can't see any such thing.

>ask lady about purple plant
If you travel Northwest, you shall find the path that will lead you home!

>nw
Home
"Wait!" says the Lady. Her arm is out trying to stop you. With the other arm, the Lady takes out a perfume bottle, sprays once, and a magical portal appears. 

 "Go on," says that Lady. "When you walk through the portal, you will arrive safe at home." 
 
You decide to trust the Lady, after all she told you how to get the key. You walk forward and the Lady gives an encouraging nod. She smiles slightly and you walk into the portal. 
 
You feel a cool breeze around your body and suddenly you're back at home. 
 
"Are you home?" calls your mother. Better go see what she needs!

You see a mirror. You should take the mirror. Welcome Home!

* * *

>drop mirror
Please give one of the answers above.

Would you like to RESTART, RESTORE a saved game, QUIT or UNDO the last command?

* * *

>clearing
That's not a verb I recognise.

>n
Clearing
In the clearing stands a lady. A woman who sneers at you. You should ask her about the treasure chest. There is also a treasure chest.

This must be a treasure chest!

* * *

>go north
Clearing
In the clearing stands a Lady who looks at you. She doesn't acknowledge you in any way, just stares. You are a bit freaked out but you don't say anything. Maybe you should ask her about the key. You should ask her about the purple plant as well. It doesn't hurt to make new friends once in a while!

>ask lady
What do you want to ask Lady for?

>ask lady about key
She stares at you and says nonchalantly, "Push the stone to get the key... Also I recently lost a pearl necklace somewhere in the forest. If you can find my pearl necklace, I will help you show you the way home. I have also seen that purple plant you've been looking for... Holy Basil it's called? I don't remember but I think was either south or southeast from here. I'm quite an old Lady, I don't remember much. But if you could find my pearl necklace, I would be a happy old Lady!"

>go southeast
You can't go that way! We have to keep going on the quest and it looks like there's dangerous poison ivy over there! Let's go a different way, it seems like a safer path.

>go south
Forest
The forest has many different trees. They are all about 20 meters high and the lowest branch is 3 feet above you. You see a key and a stone lying on the ground. You are lost in the forest and want to find a way home and the Holy Basil to heal your sick mother. There is a clearing in the North. There is more trees in the Southeast. I think I saw a Lady who can help you in the North.

The key hangs from a branch. You can't reach it. It unlocks a treasure chest.

>push stone
You push the stone and now you can reach the key!

* * *

>take key
You can't take the key because it's to high.

>push stone and take key
You can't use multiple objects with that verb.

>get on stone and take key
You can't see any such thing.

>get on stone
You get onto Stone.

* * *

>get off stone
You get off Stone.

Forest
The forest has many different trees. They are all about 20 meters high and the lowest branch is 3 feet above you. You see a key and a stone lying on the ground. You are lost in the forest and want to find a way home and the Holy Basil to heal your sick mother. There is a clearing in the North. There is more trees in the Southeast. I think I saw a Lady who can help you in the North.

>go north
Clearing
In the clearing stands a Lady who looks at you. She doesn't acknowledge you in any way, just stares. You are a bit freaked out but you don't say anything. Maybe you should ask her about the key. You should ask her about the purple plant as well. It doesn't hurt to make new friends once in a while!

>ask lady about purple plant
The purple plant I believe is at the Water Hole if I remember last!

>go north
You can't go that way! We have to keep going on the quest and it looks like there's dangerous poison ivy over there! Let's go a different way, it seems like a safer path.

>go south
Forest
The forest has many different trees. They are all about 20 meters high and the lowest branch is 3 feet above you. You see a key and a stone lying on the ground. You are lost in the forest and want to find a way home and the Holy Basil to heal your sick mother. There is a clearing in the North. There is more trees in the Southeast. I think I saw a Lady who can help you in the North.

>go southeast
Trees
There are even more trees and a path that leads Southwest. There is a treasure chest here. Do you perhaps have the key to open it?

>open treasure chest
It seems to be locked.

>open treasure chest with key
You unlock treasure chest.

>open chest
Inside the treasure chest is a pearl necklace! This must be the same pearl necklace the Lady was talking about! The pearls look real and the necklace is very pretty. You should give the necklace to the Lady... or you can keep it, whatever you choose.

>give to lady
You can't see any such thing.

>go north
You can't go that way! We have to keep going on the quest and it looks like there's dangerous poison ivy over there! Let's go a different way, it seems like a safer path.

>go south
You can't go that way! We have to keep going on the quest and it looks like there's dangerous poison ivy over there! Let's go a different way, it seems like a safer path.

I beg your pardon?

>go southeast
You can't go that way! We have to keep going on the quest and it looks like there's dangerous poison ivy over there! Let's go a different way, it seems like a safer path.

>northeast
You can't go that way! We have to keep going on the quest and it looks like there's dangerous poison ivy over there! Let's go a different way, it seems like a safer path.

>northwest
Forest
The forest has many different trees. They are all about 20 meters high and the lowest branch is 3 feet above you. You see a key and a stone lying on the ground. You are lost in the forest and want to find a way home and the Holy Basil to heal your sick mother. There is a clearing in the North. There is more trees in the Southeast. I think I saw a Lady who can help you in the North.

>n
Clearing
In the clearing stands a Lady who looks at you. She doesn't acknowledge you in any way, just stares. You are a bit freaked out but you don't say anything. Maybe you should ask her about the key. You should ask her about the purple plant as well. It doesn't hurt to make new friends once in a while!

>give lady the necklace
You can't see any such thing.

>give lady pearl necklace
You can't see any such thing.

>i
You are carrying:
  Key

>s
Forest
The forest has many different trees. They are all about 20 meters high and the lowest branch is 3 feet above you. You see a key and a stone lying on the ground. You are lost in the forest and want to find a way home and the Holy Basil to heal your sick mother. There is a clearing in the North. There is more trees in the Southeast. I think I saw a Lady who can help you in the North.

* * *

>se
Trees
There are even more trees and a path that leads Southwest. There is a treasure chest here. Do you perhaps have the key to open it?

>open chest
That's already open.

>take necklace
You should give this necklace to the Lady.

>examine chest
Treasure chest is empty.

>nw
Forest
The forest has many different trees. They are all about 20 meters high and the lowest branch is 3 feet above you. You see a key and a stone lying on the ground. You are lost in the forest and want to find a way home and the Holy Basil to heal your sick mother. There is a clearing in the North. There is more trees in the Southeast. I think I saw a Lady who can help you in the North.

>nw
You can't go that way! We have to keep going on the quest and it looks like there's dangerous poison ivy over there! Let's go a different way, it seems like a safer path.

>n
Clearing
In the clearing stands a Lady who looks at you. She doesn't acknowledge you in any way, just stares. You are a bit freaked out but you don't say anything. Maybe you should ask her about the key. You should ask her about the purple plant as well. It doesn't hurt to make new friends once in a while!

>n
You can't go that way! We have to keep going on the quest and it looks like there's dangerous poison ivy over there! Let's go a different way, it seems like a safer path.

>give lady pearl necklace
Thank you so much for finding my beautiful pearl necklace! Have you gotten the purple herb?

>no
That was a rhetorical question.

>imma ki
That's not a verb I recognise.

>ask lady about purple necklace
There is no reply.

>ask lady purple plant
I didn't understand that sentence.

>ask lady about purple plant
The purple plant I believe is at the Water Hole if I remember last!

* * *

>go south
Forest
The forest has many different trees. They are all about 20 meters high and the lowest branch is 3 feet above you. You see a key and a stone lying on the ground. You are lost in the forest and want to find a way home and the Holy Basil to heal your sick mother. There is a clearing in the North. There is more trees in the Southeast. I think I saw a Lady who can help you in the North.

>se
Trees
There are even more trees and a path that leads Southwest. There is a treasure chest here. Do you perhaps have the key to open it?

* * *

>sw
Water Hole
You see a purplish plant that looks like a herb. Maybe you should look at it... unless it's poisonous.

>take plant
You should go back to the Lady and ask her about this plant. Maybe she'll tell you scientific facts about it! Now you have the plant to heal your sick mother!

>go north
You can't go that way! We have to keep going on the quest and it looks like there's dangerous poison ivy over there! Let's go a different way, it seems like a safer path.

>go w
You can't go that way! We have to keep going on the quest and it looks like there's dangerous poison ivy over there! Let's go a different way, it seems like a safer path.

>so s
That's not a verb I recognise.

>s
You can't go that way! We have to keep going on the quest and it looks like there's dangerous poison ivy over there! Let's go a different way, it seems like a safer path.

>sw
You can't go that way! We have to keep going on the quest and it looks like there's dangerous poison ivy over there! Let's go a different way, it seems like a safer path.

>se
You can't go that way! We have to keep going on the quest and it looks like there's dangerous poison ivy over there! Let's go a different way, it seems like a safer path.

>n
You can't go that way! We have to keep going on the quest and it looks like there's dangerous poison ivy over there! Let's go a different way, it seems like a safer path.

>ne
Trees
There are even more trees and a path that leads Southwest. There is a treasure chest here. Do you perhaps have the key to open it?

* * *

>n
Clearing
In the clearing stands a Lady who looks at you. She doesn't acknowledge you in any way, just stares. You are a bit freaked out but you don't say anything. Maybe you should ask her about the key. You should ask her about the purple plant as well. It doesn't hurt to make new friends once in a while!

>ask lady about plant
There is no reply.

>ask lady about purple plant
If you travel Northwest, you shall find the path that will lead you home!

* * *

>push stone
You push the stone and now you can step on top to get the key!

>get on stone
You get onto stone.

* * *

>get off stone
You get off Stone.

Forest
The forest has many different trees. They are all about 20 meters high and the lowest branch is 3 feet above you. You see a key and a stone lying on the ground. You are lost in the forest and want to find a way home and the Holy Basil to heal your sick mother. There is a clearing in the North. There is more trees in the Southeast. I think I saw a Lady who can help you in the North.

>n
Clearing
In the clearing stands a Lady who looks at you. She doesn't acknowledge you in any way, just stares. You are a bit freaked out but you don't say anything. Maybe you should ask her about the key. You should ask her about the purple plant as well. It doesn't hurt to make new friends once in a while!

* * *

>ask lady about key
She stares at you and says nonchalantly, "Push the stone to get the key... Also I recently lost a pearl necklace somewhere in the forest. If you can find my pearl necklace, I will help you show you the way home. I have also seen that purple plant you've been looking for... Holy Basil it's called? I don't remember but I think was either south or southeast from here. I'm quite an old Lady, I don't remember much. But if you could find my pearl necklace, I would be a happy old Lady!"

>s
Forest
The forest has many different trees. They are all about 20 meters high and the lowest branch is 3 feet above you. You see a key and a stone lying on the ground. You are lost in the forest and want to find a way home and the Holy Basil to heal your sick mother. There is a clearing in the North. There is more trees in the Southeast. I think I saw a Lady who can help you in the North.

* * *

>se
Trees
There are even more trees and a path that leads Southwest. There is a treasure chest here. Do you perhaps have the key to open it?

>open chest with key
You unlock treasure chest.

>open chest
Inside the treasure chest is a pearl necklace! This must be the same pearl necklace the Lady was talking about! The pearls look real and the necklace is very pretty. You should give the necklace to the Lady... or you can keep it, whatever you choose.

>take necklace
You should give this necklace to the Lady.

>sw
Water Hole
You see a purplish plant that looks like a herb. Maybe you should look at it... unless it's poisonous.

>ne
Trees
There are even more trees and a path that leads Southwest. There is a treasure chest here. Do you perhaps have the key to open it?

* * *

>nw
Forest
The forest has many different trees. They are all about 20 meters high and the lowest branch is 3 feet above you. You see a key and a stone lying on the ground. You are lost in the forest and want to find a way home and the Holy Basil to heal your sick mother. There is a clearing in the North. There is more trees in the Southeast. I think I saw a Lady who can help you in the North.

>s
You can't go that way! We have to keep going on the quest and it looks like there's dangerous poison ivy over there! Let's go a different way, it seems like a safer path.

>n
Clearing
In the clearing stands a Lady who looks at you. She doesn't acknowledge you in any way, just stares. You are a bit freaked out but you don't say anything. Maybe you should ask her about the key. You should ask her about the purple plant as well. It doesn't hurt to make new friends once in a while!

>give lady necklace
Thank you so much for finding my beautiful pearl necklace! Have you gotten the purple herb?

>ask lady about purple plant
The purple plant I believe is at the Water Hole if I remember last!

* * *

>sw
Water Hole
You see a purplish plant that looks like a herb. Maybe you should look at it... unless it's poisonous.

>take plant
You should go back to the Lady and ask her about this plant. You should ask her even though you have it. Maybe she'll tell you scientific facts about it!

>ne
Trees
There are even more trees and a path that leads Southwest. There is a treasure chest here. Do you perhaps have the key to open it?

>n
You can't go that way! We have to keep going on the quest and it looks like there's dangerous poison ivy over there! Let's go a different way, it seems like a safer path.

>nw
Forest
The forest has many different trees. They are all about 20 meters high and the lowest branch is 3 feet above you. You see a key and a stone lying on the ground. You are lost in the forest and want to find a way home and the Holy Basil to heal your sick mother. There is a clearing in the North. There is more trees in the Southeast. I think I saw a Lady who can help you in the North.

* * *

>n
Clearing
In the clearing stands a Lady who looks at you. She doesn't acknowledge you in any way, just stares. You are a bit freaked out but you don't say anything. Maybe you should ask her about the key. You should ask her about the purple plant as well. It doesn't hurt to make new friends once in a while!

>ask lady about purple plant
If you travel Northwest, you shall find the path that will lead you home!

>nw
Home
"Wait!" say the Lady. Her arm is out trying to stop you. With the other arm, the Lady takes out a perfume bottle, sprays once, and a magical portal appears. 

 "Go on," says that Lady. "When you walk through the portal, you will arrive safe at home." 
 
You decide to trust the Lady, after all she told you how to get the key. You walk forward and the Lady gives an encouraging nod. She smiles slightly and you walk into the portal. 
 
You feel a cool breeze around your body and suddenly you're back at home. 
 
"Are you home?" calls your mother. Better go see what she needs!

You see a mirror. You should take the mirror. Welcome Home!

>take mirror
You have reached home! You are as perfect as when you left the cottage and now you even have the Holy Basil! You're glowing and have a bright smile on your face. Have a wonderful day!

    *** You have finished the game! Congrats! ***

Would you like to RESTART, RESTORE a saved game, QUIT or UNDO the last command?

>undo
Home
[Previous turn undone.]

* * *

>stand on top of the stone
You can't see any such thing.

>stand on the stone
That's not something you can stand on.

* * *

>n
Clearing
In the clearing stands a Lady who looks at you. She doesn't acknowledge you in any way, just stares. You are a bit freaked out but you don't say anything. It doesn't hurt to make new friends once in a while! Maybe you should ask her about the key.

>x lady
You see nothing special about Lady.

* * *

>se
Trees
There are even more trees and a path that leads Southwest. There is a treasure chest here. Do you perhaps have the key to open it?

* * *

>sw
Water Hole
You see a purplish plant that looks like a herb. Maybe you should look at it... unless it's poisonous.

>take plant
Now you have the plant to heal your sick mother! You should find the Lady her pearl necklace.

>ne
Trees
There are even more trees and a path that leads Southwest. There is a treasure chest here. Do you perhaps have the key to open it?

>nw
Forest
The forest has many different trees. They are all about 20 meters high and the lowest branch is 3 feet above you. You see a key and a stone lying on the ground. You are lost in the forest and want to find a way home and the Holy Basil to heal your sick mother. There is a clearing in the North. There is more trees in the Southeast. I think I saw a Lady who can help you in the North.

The key hangs from a branch. You can't reach it. It unlocks a treasure chest.

>take key
You can't take the key because it's to high.

>push stone
You push the stone and now you can reach the key!

* * *

>sw
Water Hole
You see a purplish plant that looks like a herb. Maybe you should look at it... unless it's poisonous.

>take purple plant
Now you have the plant to heal your sick mother! You should find the Lady her pearl necklace.

I beg your pardon?

>ne
Trees
There are even more trees and a path that leads Southwest. There is a treasure chest here. Do you perhaps have the key to open it?

* * *

>nw
Forest
The forest has many different trees. They are all about 20 meters high and the lowest branch is 3 feet above you. You see a key and a stone lying on the ground. You are lost in the forest and want to find a way home and the Holy Basil to heal your sick mother. There is a clearing in the North. There is more trees in the Southeast. I think I saw a Lady who can help you in the North.

The key hangs from a branch. You can't reach it. It unlocks a treasure chest.

>n
Clearing
In the clearing stands a Lady who looks at you. She doesn't acknowledge you in any way, just stares. You are a bit freaked out but you don't say anything. Maybe you should ask her about the key. You should ask her about the purple plant as well. It doesn't hurt to make new friends once in a while!

* * *

>push stone
You push the stone and now you can reach the key!

>get on stone
You get onto Stone.

* * *

>unlock chest with key
You unlock treasure chest.

>open chets
You can't see any such thing.

>open chest
Inside the treasure chest is a pearl necklace! This must be the same pearl necklace the Lady was talking about! The pearls look real and the necklace is very pretty. You should give the necklace to the Lady... or you can keep it, whatever you choose.

* * *

>n
Clearing
In the clearing stands a Lady who looks at you. She doesn't acknowledge you in any way, just stares. You are a bit freaked out but you don't say anything. Maybe you should ask her about the key. You should ask her about the purple plant as well. It doesn't hurt to make new friends once in a while!

>give necklace to lady
Thank you so much for finding my beautiful pearl necklace!  If you travel Northwest, you shall find the path that leads to home.

>nw
Home
"Wait!" say the Lady. Her arm is out trying to stop you. With the other arm, the Lady takes out a perfume bottle, sprays once, and a magical portal appears. 

 "Go on," says that Lady. "When you walk through the portal, you will arrive safe at home." 
 
You decide to trust the Lady, after all she told you how to get the key. You walk forward and the Lady gives an encouraging nod. She smiles slightly and you walk into the portal. 
 
You feel a cool breeze around your body and suddenly you're back at home. 
 
"Are you home?" calls your mother. Better go see what she needs!

You see a mirror. You should take the mirror. Welcome Home!

>take mirrow
You can't see any such thing.

>take mirror
You have reached home! You are as perfect as when you left the cottage and now you even have the Holy Basil! You're glowing and have a bright smile on your face. Have a wonderful day!

    *** After you took the mirror, you looked very much the same. You saved your mother using the Holy Basil. You never did see the Lady again, but you always thought of her. Like "How did she even use a PERFUME bottle to open a portal?" you never found the answer, but you knew you were always in her debt. Although she stared at you quite creepily. ***

Would you like to RESTART, RESTORE a saved game, QUIT or UNDO the last command?